25 20
#############
#...........#    ########
#...s...s...######.k....#
#.......................#
#...........######......#
#.....s.....#    #......#
#.w.........#    #......#
#...........#    #......#
#####..######    ###..###
    #..#           #..#
    #..#           #..#
    #..#          ##..##
  ###..####      #......#
  #..@....#      #......#
  #.......#      #......#
  #.......#      #......#
  #.k...w.#      #......#
  #.......#      #......#
  #.......#      #......#
  #########       ######
